1111111111111111
1000001000010001
1010001000010001
1000100010010001
1010001000001001
1001001000000001
1010000000010011
1010000100000001
0000000000000000